10 10
K 0 1 0 P 0 e 0 p 0
1 0 p 0 1 E K 0 1 0
1 0 0 0 p 0 1 0 0 p
0 0 P 0 p X 0 0 1 0
0 1 1 0 e 1 1 0 1 0
E 0 0 0 1 0 p 0 0 0
0 1 1 0 0 0 1 0 1 0
0 0 0 0 1 0 p 0 0 0
1 0 0 0 p 0 1 0 0 p
1 0 E 0 1 E 1 0 C 0