8 10
0 0 1 0 P 0 e 0 p 0
1 0 p 0 1 E 1 0 1 0
1 X 1 0 1 0 1 0 0 p
0 0 P 0 p 0 0 0 1 0
0 1 1 0 K 1 1 0 1 0
0 0 0 0 1 0 p 0 0 0
0 1 1 0 0 1 1 0 1 0
1 0 p 0 1 E 1 0 C 0